{
    "map":
    [
        [6, 6, 6, 6, 6, 6, 6, 6, 6],
        [0, 0, 0, 0, 5, 0, 0, 0, 6],
        [6, 0, 1, 1, 2, 4, 4, 0, 6],
        [6, 5, 3, 0, 0, 0, 3, 5, 6],
        [6, 5, 3, 0, 0, 0, 3, 0, 5],
        [6, 0, 1, 1, 2, 4, 1, 0, 6],
        [6, 0, 0, 0, 5, 5, 0, 0, 6],
        [6, 6, 6, 6, 6, 6, 6, 0, 6]
    ],
    "mapping":["floor", "wall", "door", "window", "softWall", "entrance", "barrier"]
}
