{
    "map":
    [
        [6, 6, 6, 6, 6, 6, 6, 6, 6],
        [6, 6, 6, 6, 5, 6, 6, 6, 6],
        [6, 6, 1, 3, 3, 3, 1, 6, 6],
        [6, 5, 3, 0, 0, 0, 3, 5, 6],
        [6, 5, 3, 0, 0, 0, 3, 6, 5],
        [6, 6, 1, 3, 3, 3, 1, 6, 6],
        [6, 6, 6, 6, 5, 5, 6, 6, 6],
        [6, 6, 6, 6, 6, 6, 6, 6, 6]
    ],
    "mapping":["floor", "wall", "door", "window", "softWall", "entrance", "barrier"]
}
